factory	CVCCVCV	3,5	ˈfak-t(ə-)rē
industry	VCCVCCCV	2,5	ˈin-(ˌ)dəs-trē
fence	CVCCC		ˈfen(t)s
boil	CVVC	2	ˈbȯi(-ə)l
cupola	CVCVCV	2,4	ˈkyü-pə-lə
February	CVCVCVCV	2,4,7	ˈfe-b(y)ə-ˌwer-ē
schwa	CCV		ˈshwä
eel	VC		ˈēl
sour	CVVC	2	ˈsau̇(-ə)r
lock	CVC		ˈläk
key	CV		ˈkē
hurry	CVCV	3	ˈhər-ē
bird	CVCC		ˈbərd
hum	CVC		ˈhəm
hurry	CVCV	3	ˈhər-ē
morpheme	CVCCVC	3	ˈmȯr-ˌfēm
worry	CVCV	3	ˈwər-ē
furry	CVCV	3	ˈfər-ē
stirring			0
purring			0
fur	CVC		ˈfər
stir	CCVC		ˈstər
purr	CVC		ˈpər
map	CVC		ˈmap
mad	CVC		ˈmad
gag	CVC		ˈgag
can	CVC		kən
cot	CVC		ˈkät
cod	CVC		ˈkäd
collar	CVCVC	2	ˈkä-lər
caught	CVC		ˈkȯt
cawed			0
caller	CVCVC	2	ˈkä-lər
cot	CVC		ˈkät
caught	CVC		ˈkȯt
cod	CVC		ˈkäd
cawed			0
collar	CVCVC	2	ˈkä-lər
caller	CVCVC	2	ˈkä-lər
card	CVCC		ˈkärd
cart	CVCC		ˈkärt
card	CVCC		ˈkärd
cod	CVC		ˈkäd
cawed			0
cart	CVCC		ˈkärt
cot	CVC		ˈkät
caught	CVC		ˈkȯt
card	CVCC		ˈkärd
cart	CVCC		ˈkärt
bother	CVCCVC	2	ˈbä-thər
father	CVCCVC	2	ˈfä-thər
calm	CVC		ˈkäm
palm	CVC		ˈpäm
tomato	CVCVC	2,4	tə-ˈmā-(ˌ)tō; chiefly British
watch	CVC		ˈwäch
what	CVC		ˈhwät
swap	CCVC		ˈswäp
waft	CVCC		ˈwäft
after	VCCVC	2	ˈaf-tər
bath	CVCC		ˈbath
mask	CVCC		ˈmask
slant	CCVCC		ˈslant
patte			0
chat	CVC		ˈchat
house	CVC		ˈhau̇s
out	VC		ˈau̇t
allophones			0
pen	CVC		ˈpen
whale	CVC		ˈhwāl
wail	CVC		ˈwāl
shy	CCV		ˈshī
five	CVC		ˈfīv
nice	CVC		ˈnīs
write	CVC		ˈrīt
allophones			0
ich			0
Buch			0
battle	CVCVC	2	ˈba-təl
fiddle	CVCVC	2	ˈfi-dəl
open	CVC		ˈō-pən
happen	CVCVC	2	ˈha-pən
cotton	CVCVC	2	ˈkä-tən
sudden	CVCVC	2	ˈsə-dən
following	CVCVCVC	2,4	ˈfä-lə-wiŋ
bird	CVCC		ˈbərd
bird	CVCC		ˈbərd
guidwillie	CVCCVCV	3,5	gœd-ˈwi-lē
drawing	CCVVC	3	ˈdrȯ(-)iŋ
sawing			0
coin	CVC		ˈkȯin
drawing	CCVVC	3	ˈdrȯ(-)iŋ
sawing			0
pray	CCV		ˈprā
tree	CCV		ˈtrē
cram	CCVC		ˈkram
bright	CCVC		ˈbrīt
grow	CC		ˈgrō
beard	CVCC		ˈbird
corn	CVCC		ˈkȯrn
assured	VCCVCC	1	ə-ˈshu̇rd
car	CVC		ˈkär
card	CVCC		ˈkärd
cart	CVCC		ˈkärt
bird	CVCC		ˈbərd
hurt	CVCC		ˈhərt
grasshopper	CCVCCVCVC	4,6	ˈgras-ˌhä-pər
ladder	CVCVC	2	ˈla-dər
latter	CVCVC	2	ˈla-tər
leader	CVCVC	2	ˈlē-dər
liter	CVCVC	2	ˈlē-tər
parody	CVCVCV	3,4	ˈper-ə-dē
parity	CVCVCV	3,4	ˈper-ə-tē
button	CVCVC	2	ˈbə-tən
knighthood	CVCCVC	3	ˈnīt-ˌhu̇d
valuing			0
news	CVC		ˈnüz
musician	CVCVCCVC	2,4	myü-ˈzi-shən
lewd	CVC		ˈlüd
suit	CVC		ˈsüt
presume	CCVCVC	3	pri-ˈzüm
hue	CV		ˈhyü
huge	CVC		ˈhyüj
rouille	CVV	2	ˈrü-ē
French	CCVCC		ˈfrench
yard	VCC		ˈyärd
yard	VCC		ˈyärd
digne			0
hogshead	CVCCCVC	4	ˈhȯgz-ˌhed
hashtag	CVCCCVC	4	ˈhash-ˌtag
steampunk	CCVCCVCC	4	ˈstēm-ˌpəŋk
selfie	CVCCV	3	ˈsel-fē
banana	CVCVCV	2,4	bə-ˈna-nə
collide	CVCVC	2	kə-ˈlīd
humdrum	CVCCCVC	3	ˈhəm-ˌdrəm
abut	VCVC	1	ə-ˈbət
